一: one
丨: line, stick
丶: dot
丿: bend, possessive particle no
乙(乚): second, latter
亅: hook, hooked stick
二: two
亠: pot lid
人(亻,𠆢): human
儿: legs, human underneath
入(𠆢): enter
八(ハ): eight, eight-head
冂: inverted box, window frame
冖: cover, wa crown
冫: ice, 2-stroke water
几: desk
凵: container, inbox
刀(刂,⺈): sword
力: power, force
勹: embrace, wrap frame
匕: spoon hi
匚: box frame
亡(匸): dead, hiding frame
十: ten, complete
卜(⼘,⺊): divination to
卩(㔾): seal
厂: cliff
厶: private
又: again, right hand
口: mouth, opening
囗: enclosure
土: earth
士: scholar, bachelor
夂: winter
夊: winter variant
夕: evening, sunset
大: big, very
女: woman, female
子: child, seed
宀: roof
寸: sun
小(⺌,⺍): small, insignificant
尢(尤,尣): lame
尸: corpse
屮: sprout
山: mountain
巛(川,巜): river
工: work
已(己,巳): oneself
巾: cloth, turban, scarf
干: dry
幺: short thread
广: dotted cliff
廴: long stride
廾: two hands, twenty
弋: ceremony, shoot, arrow
弓: bow
彐(彑): pig's head
彡: hair, bristle, stubble, beard
彳: step
心(忄,⺗): heart
戈: spear, halberd
戸(戶,户): door, house
手(扌,龵): hand
支: branch
攵(攴): strike, whip
文: script, literature
斗: dipper, measuring scoop
斤: axe
方: way, square, raft
无(旡): have not
日: sun, day
曰: say
月(⺝): moon, month; body, flesh
木: tree
欠: yawn, lack
止: stop
歹(歺): death, decay
殳: weapon, lance
毋(母,⺟): do not; mother
比: compare, compete
毛: fur, hair
氏: clan
气: steam, breath
水(氵,氺): water
火(灬): fire
爪(爫,⺥,⺤): claw, nail, talon
父: father
爻: mix, twine, cross
爿(丬): split wood
片: (a) slice
牙: fang
牛(牜,⺧): cow
犬(犭): dog
玄: dark, profound
王(玉,玊,⺩): king; ball, jade
瓜: melon
瓦: tile
甘: sweet
生: life
用(甩): use;
田: field
疋(⺪): bolt of cloth
疒: sickness
癶: footsteps
白: white
皮: skin
皿: dish
目: eye
矛: spear, pike
矢: arrow
石: stone
示(礻): altar, display
禸: track
禾: two-branch tree
穴: cave
立: stand, erect
竹(⺮): bamboo
米: rice
糸(糹): thread, string
缶: can, earthenware jar
罒(网,罓,⺲,⺳): net
羊(⺶,⺷): sheep
羽: feather, wing
耂(老,⺹): old
而: rake, beard
耒: plow
耳: ear
聿(⺻): brush
肉(⺼,月): meat
臣: minister, official
自: oneself
至: arrive
臼: mortar
舌: tongue
舛: opposite
舟: boat
艮: stopping
色: colour, prettiness
艹(艸,䒑): grass, vegetation
虍: tiger stripes
虫: insect
血: blood
行: go, do
衣(衤): clothes
西(襾,覀): west
見: see
角: horn
言(訁): speech
谷: valley
豆: bean
豕: pig
豸: cat, badger
貝: shell
赤: red, bare
走(赱): run
足(⻊): foot
身: body
車: cart, car
辛: spicy, bitter
辰: morning
⻌(辵,辶): walk
邑(⻏,阝): town
酉: sake
釆: divide, distinguish, choose
里: village, mile
金(釒): metal, gold
長(镸): long, grow; leader
門: gate
阜(⻖,阝): mound, dam
隶: slave, capture
隹: old bird
雨(⻗): rain
青(靑): green, blue
非: wrong
面(靣): face
革: leather, rawhide
韋: tanned leather
韭: leek
音: sound
頁: big shell
風(𠘨): wind
飛: fly
食(飠,𩙿): eat, food
首: neck, head
香: fragrant
馬: horse
骨: bone
高(髙): tall, high
髟: hair
鬥: fight
鬯: herbs, sacrificial wine
鬲: tripod, cauldron
鬼: ghost, demon
魚: fish
鳥: bird
鹵: salt
鹿: deer
麦(麥): wheat
麻: hemp, flax
黄(黃): yellow
黍: millet
黒(黑): black
黹: embroidery, needlework
黽: frog, amphibian
鼎: sacrificial tripod
鼓: drum
鼠: rat, mouse
鼻: nose
齊: even, uniformly
歯(齒): tooth, molar
竜(龍): dragon
亀(龜): turtle, tortoise
龠: flute
